1111111111111111111111111
100000001100001000000001
100000010010010000000001
100000100N01100000000001111111111
100001100011000001110000000000001
100010010011000001110111111111111
11110111111111011100000010001
11110111111111011101010010001
11000000110101011100000010001
10000000000000001100000010001
10000000000000001101010010001
1100000111010101111101111000111
11110111 1110101 101111010001
11111111 1111111 111111111111