NO assets/sprites/wall-no.xpm
SO assets/sprites/wall-so.xpm

WE assets/sprites/wall-we.xpm

EA assets/sprites/wall-ea.xpm

F 155,155,0




C 100,0,100

1111111
1E00011
1000001
1001001
1111111