NO x.xpm
SO xx.xpm

WE assets/sprites/wall-we.xpm

EA assets/sprites/wall-ea.xpm

F 55,55,55




C 100,0,69



1111111111111111111111
1000000000000000000001
1000000000000000000001
1000000000000000000001
1000000000000000000001
1000000000N00000000001
1000000000000000000001
1000000000000000000001
1000000000000000000001
1000000000000000000001
1111111111111111111111
