NO assets/sprites/wall-no.xpm
SO assets/sprites/wall-so.xpm

WE assets/sprites/wall-we.xpm

EA assets/sprites/wall-ea.xpm

F 155,155,0




C 100,0,100



1111111111111111111111
1000000000000000000001
1000000000000000000001
1111111000111000111011
1000000000000000000001
1000000000110001100001
1000011100000001111001
1000000011100000000001
1000000011100000000001
10000000111000000N0001
1111111111111111111111