NO assets/sprites/black_sprite.xpm
SO assets/sprites/black_sprite.xpm

WE assets/sprites/black_sprite.xpm

EA assets/sprites/black_sprite.xpm

F 220,100,0




C 225, 30,0

11111111111111111111111111111
10100000011100000000000000001
10010000100100000000000010001
10001001000000000000000010001
1011011011100000000000010001
10000000001100000111011110001
11110111111111011100000010001
11110111111111011100000010001
11000000110101011101010010001
10000000000000001100100010001
10000000000000001101010010001
11000000110101000000000000001
11111111111101000000000000001
10000000001100000100000010001
1000N000000000001010000111001
10000000001000010001010101001
10000000001101000000N00000001
10000000001100000001010000001
11111111111111111111111111111