NO assets/sprites/wall-no.xpm
SO assets/sprites/wall-so.xpm

WE assets/sprites/wall-we.xpm

EA assets/sprites/wall-ea.xpm

F 155,155,0




C 0,0,0

1111111111111111111111111111111111111111111111111111111111111111111111111111111111
1N00000000000000000000000000000000000000000000000000000000000000000000000000000001
1010000000000000000000000000000000000000000000000000000000000000000000000000000001
1001000000000000000000000000000000000000000000000000000000000000000000000000000001
1000110000000000000000000000000000000000000000000000000000000000000000000000000001
1000001000000000000000000000000000000000000000000000000000000000000000000000000001
1000000110000000000000000000000000000000000000000000000000000000000000000000000001
100000001100000000000000000000000000000000000000000000000000000000000000000000001
1000000000100000000000000000000000000000000000000000000000000000000000000000000001
1000000000000000000000000000000000000000000000000000000000000000000000000000000001
1000000000000000000000000000000000000000000000000000000000000000000000000000000001
1000000000000000000000000000000000000000000000000000000000000000000000000000000001
1000000000000000000000000000000000000000000000000000000000000000000000000000000001
1000000000000000000000000000000000000000000000000000000000000000000000000000000001
1000000000000000000000000000000000000000000000000000000000000000000000000000000001    1
1000000000000000000000000000000000000000000000000000000000000000000000000000000001   111
1000000000000000000000000000000000000000000000000000000000000000000000000000000001111111111111
1000000000000000000000000000000000000000000000000000000000000000000000000000000001
1000000000000000000000000000000000000000000000000000000000000000000000000000000001
1000000000000000000000000000000000000000000000000000000000000000000000000000000001
1111111111111111111111111111111111111111111111111111111111111111111111111111111111