11111111111111111111111111111
10000000001100000000000000001
10110000011100000000000010001
1N010000000000000000000010001
10110000011100000000000010001
10000000001100000111011110001
11110111111111011100000010001
11110111111111011101010010001
11000000110101011100000010001
10000000000000001100000010001
10000000000000001101010010001
10000000000100000001010000001
11111111111111111111111111111